11111111111111111
10000000000000001
10000000000000001
10000000000000001
10001111000011111
10001111000011111
10001111000011111
10001111000011111
10001111111111111
10001111111111111
10000000000011111
100C0000000011111
10000C00000011111
10000C00000011111
10000000000000001
10000000000000001
10P0000000000E001
11111111111111111