11111111111111111111111111111111111
10000000000000000001001111111000001
10000000000000000001010000000110001
10000000000000000000010100000001001
1000111100001111001111111111111E011
10001111000011110011111111111101001
10001111000011110011110000111100111
10001111000011110011110000111100001
10001111111111110000000011110000001
1000111111111111000000111100000P001
10000000000011110000111100000000001
100C0000000011110011110000111100001
10000C00000011110011111111111100001
10000C00000011110011111111111100001
10000000000000000000000000000000001
10000000000000000000000000000000111
100000000000000000000000000000000C1
11111111111111111111111111111111111
